id	uuid
created_at	timestamp
product_id	varchar(255)
product_name	varchar(500)
product_sku	varchar(255)
supplier_id	varchar(255)
supplier_name	varchar(500)
quantity_on_hand	integer
quantity_reserved	integer
quantity_available	integer
minimum_stock_level	integer
reorder_point	integer
optimal_stock_level	integer
reorder_quantity	integer
average_daily_usage	numeric(10,2)
last_order_date	date
last_stock_count_date	date
unit_cost	numeric(12,2)
total_value	numeric(15,2)
expiration_date	date
batch_number	varchar(255)
warehouse_location	varchar(255)
shelf_location	varchar(255)
stock_status	smallint
is_active	boolean
last_updated_at	timestamp
notes	text
created_by_id	uuid
